q5.ox
q..............
qo.............
q.....ooo..o...
q..............
q..............
q.......o..o...
q.....o........
q.....o........
q..............
q..............
q..............
q.o............
q...o....o.....
q..o...........
q..............
